#!/bin/bash

# =============================================================================
# aliases
# =============================================================================
alias b='bash'
alias e='echo'
alias h='head'
alias l='ls'
alias p='python'
alias t='task'
alias w='which'
alias v='vim'

alias p3='python3'
alias ls='ls --color=auto'
alias ta='tmux attach; or tmux'
alias rm='rm -i'
alias cp='cp -i'
alias mv='mv -i'
alias hn='head -n'
alias ss='sudo service'
alias pi='ipython'
alias vp='vim -p'
alias vd='vimdiff'
alias vs='vim - ; fg'
alias sv='sudo vim'
alias vv='vim -p *.{h,c{,c,++,xx,pp},java,sh,py,md,html,css,js,php,pl,txt}'
alias lo='locate -A'

alias sai='sudo apt install'
alias kut='cut -d " " -f'
alias aup='sudo apt update; sudo apt upgrade; sudo apt-get autoremove'
alias dsh='du -sh'
alias dfh='df -h'
alias lsn='ls -al --time-style=+%D | grep `date +%D` '
alias how='howdoi -c'

alias  vvim='v ~/.vimrc'
alias vtmux='v ~/.tmux.conf'
alias vfish='v ~/.config/fish/config.fish'
alias vbash='v ~/.bashrc'
alias sfish='. ~/.config/fish/config.fish'
alias sbash='. ~/.bashrc'

alias   ..='cd ../;ls'
alias  ...='cd ../../;ls'
alias ....='cd ../../../;ls'

alias    qc='vim ~/*/code/c/quick/quick.c'
alias   qpy='vim ~/*/code/python/quick.py'
alias qjava='vim ~/*/code/java/Quick/Quick.java'
alias   qsh='vim ~/*/code/shell/quick.sh'

alias dos2unix='recode dos/CR-LF..l1'
alias unix2win='recode l1..windows-1250'
alias unix2dos='recode l1..dos/CR-LF'

alias     xklip='head -c -1 | xclip -selection c'
alias     shttp='python -m SimpleHTTPServer'
alias startsshd='sudo mkdir -p -m0755 /var/run/sshd; sudo /usr/sbin/sshd'
